10 15 70
---------------
H H  *   *  H H
H%H  #   #  H*H
##H         H##
+-H--  @ *--H-+
# H  #####  H #
  H         H  
 H+H-------H+H 
* H    * %  H %
###############
