10 15 20
+@+************
+##---------H *
+%%%%%%%%   H *
+########   H *
+           H *
+           H *
+           * *
+ *%--------# *
+ ##          *
+**************
