20 20 40
                    
                    
 + + +@  *H         
 #########H         
          H         
          H-------- 
          H   H   H 
          H   H %*H 
   -------H   H ### 
   H      H   H     
   H          H     
   H  *+ % *  H     
   H ######## H     
   H          H     
   H          H     
   H          H     
   H          H     
   H          H     
  %H+  *      H   + 
####################
