10 15
*@*************
*##---------H *
*%%%%%%%%   H *
*########   H *
*           H *
*           H *
*           * *
* *%--------# *
* ##          *
***************
