10 15 -1
@ -----------++
##    H H    ##
 -----H-H----- 
 H  * H+H    H 
 H  ###H###  H 
 H     H    +H 
+HH    H    HH+
##H+H--H--H H##
####H +H+ H####
###############

